1111111111111111111111
1000E0000B00000C000C01
1010010100100000101001
1010010010101010B01001
1P0B00000C00C000000001
1111111111111111111111